+---+---+---+---+---+---+---+---+---+---+---+---+---+---+---+---+
|           |   |       |       |       |   |               |   |
+   +---+   +   +   +---+   +---+   +---+   +---+   +---+   +   +
|   |       |           |       |       |   |       |           |
+---+   +   +---+   +---+   +   +   +   +   +---+---+---+   +   +
|       |               |   |   |   |       |   |           |   |
+---+---+   +---+   +---+---+   +---+   +---+   +---+---+   +---+
|       |   |   |       |               |               |       |
+   +---+   +   +   +---+---+   +   +   +---+---+---+   +---+   +
|           |   |   |           |   |   |                       |
+---+   +---+   +---+   +---+   +---+---+   +---+   +   +---+---+
|       |   |               |       |   |   |       |       |   |
+   +---+   +---+---+   +   +---+---+   +   +   +---+   +   +   +
|   |       |           |           |       |       |   |   |   |
+   +---+   +---+   +   +---+   +   +---+---+---+---+   +   +   +
|   |               |   |       |               |       |       |
+   +---+---+---+   +---+---+   +---+   +   +---+---+   +---+---+
|       |       |       |       |       |       |               |
+---+   +---+   +   +---+   +---+   +   +---+   +---+   +   +   +
|           |   |       |   |       |   |   |       |   |   |   |
+   +   +---+   +   +---+   +   +---+   +   +   +   +   +---+   +
|   |   |       |   |   |   |   |   |   |   |   |       |       |
+---+   +   +   +   +   +---+---+   +---+   +   +   +---+   +---+
|           |           |                       |   |   |       |
+   +   +---+---+---+   +---+   +   +---+---+   +   +   +---+   +
|   |               |   |       |   |   |       |           |   |
+   +   +---+   +---+---+---+---+---+   +---+---+   +---+   +---+
|   |       |   |   |   |       |   |   |   |       |       |   |
+   +   +---+---+   +   +   +---+   +   +   +   +   +---+---+   +
|   |   |           |   |               |       |               |
+   +---+   +   +---+   +---+   +---+   +   +   +   +---+---+---+
|           |   |               |           |   |               |
+---+---+---+---+---+---+---+---+---+---+---+---+---+---+---+---+
